{
  "name": "First Contact",
  "width": 20,
  "height": 15,
  "terrain": [
    [
      "GRASS",
      "FOREST",
      "GRASS",
      "GRASS",
      "GRASS",
      "GRASS",
      "GRASS",
      "FOREST",
      "GRASS",
      "FOREST",
      "ROAD",
      "GRASS",
      "FOREST",
      "GRASS",
      "GRASS",
      "GRASS",
      "GRASS",
      "GRASS",
      "GRASS",
      "FOREST"
    ],
    [
      "GRASS",
      "GRASS",
      "GRASS",
      "GRASS",
      "GRASS",
      "GRASS",
      "FOREST",
      "FOREST",
      "GRASS",
      "GRASS",
      "ROAD",
      "GRASS",
      "GRASS",
      "GRASS",
      "GRASS",
      "GRASS",
      "GRASS",
      "GRASS",
      "GRASS",
      "GRASS"
    ],
    [
      "GRASS",
      "FOREST",
      "GRASS",
      "GRASS",
      "FOREST",
      "GRASS",
      "FOREST",
      "GRASS",
      "GRASS",
      "GRASS",
      "ROAD",
      "GRASS",
      "GRASS",
      "GRASS",
      "GRASS",
      "GRASS",
      "GRASS",
      "GRASS",
      "GRASS",
      "GRASS"
    ],
    [
      "GRASS",
      "GRASS",
      "GRASS",
      "GRASS",
      "GRASS",
      "GRASS",
      "GRASS",
      "FOREST",
      "GRASS",
      "GRASS",
      "ROAD",
      "GRASS",
      "GRASS",
      "GRASS",
      "GRASS",
      "GRASS",
      "GRASS",
      "GRASS",
      "GRASS",
      "GRASS"
    ],
    [
      "GRASS",
      "GRASS",
      "GRASS",
      "GRASS",
      "GRASS",
      "GRASS",
      "GRASS",
      "GRASS",
      "FOREST",
      "FOREST",
      "ROAD",
      "GRASS",
      "GRASS",
      "GRASS",
      "FOREST",
      "GRASS",
      "GRASS",
      "GRASS",
      "GRASS",
      "GRASS"
    ],
    [
      "FOREST",
      "GRASS",
      "GRASS",
      "GRASS",
      "GRASS",
      "GRASS",
      "FOREST",
      "GRASS",
      "GRASS",
      "GRASS",
      "ROAD",
      "GRASS",
      "GRASS",
      "GRASS",
      "GRASS",
      "GRASS",
      "GRASS",
      "GRASS",
      "GRASS",
      "GRASS"
    ],
    [
      "GRASS",
      "GRASS",
      "GRASS",
      "GRASS",
      "FOREST",
      "GRASS",
      "FOREST",
      "GRASS",
      "GRASS",
      "SHALLOW_WATER",
      "ROAD",
      "SHALLOW_WATER",
      "GRASS",
      "GRASS",
      "FOREST",
      "GRASS",
      "FOREST",
      "GRASS",
      "GRASS",
      "SAND"
    ],
    [
      "GRASS",
      "GRASS",
      "GRASS",
      "GRASS",
      "GRASS",
      "GRASS",
      "GRASS",
      "GRASS",
      "GRASS",
      "SHALLOW_WATER",
      "ROAD",
      "SHALLOW_WATER",
      "GRASS",
      "GRASS",
      "SAND",
      "GRASS",
      "GRASS",
      "GRASS",
      "GRASS",
      "GRASS"
    ],
    [
      "FOREST",
      "GRASS",
      "GRASS",
      "GRASS",
      "GRASS",
      "FOREST",
      "GRASS",
      "GRASS",
      "GRASS",
      "SHALLOW_WATER",
      "ROAD",
      "SHALLOW_WATER",
      "GRASS",
      "GRASS",
      "GRASS",
      "GRASS",
      "FOREST",
      "GRASS",
      "GRASS",
      "GRASS"
    ],
    [
      "GRASS",
      "GRASS",
      "GRASS",
      "FOREST",
      "GRASS",
      "GRASS",
      "GRASS",
      "GRASS",
      "GRASS",
      "GRASS",
      "ROAD",
      "GRASS",
      "GRASS",
      "GRASS",
      "GRASS",
      "GRASS",
      "GRASS",
      "FOREST",
      "GRASS",
      "GRASS"
    ],
    [
      "GRASS",
      "GRASS",
      "GRASS",
      "GRASS",
      "GRASS",
      "GRASS",
      "GRASS",
      "FOREST",
      "GRASS",
      "GRASS",
      "ROAD",
      "GRASS",
      "GRASS",
      "GRASS",
      "GRASS",
      "GRASS",
      "GRASS",
      "GRASS",
      "GRASS",
      "GRASS"
    ],
    [
      "GRASS",
      "GRASS",
      "GRASS",
      "GRASS",
      "FOREST",
      "GRASS",
      "GRASS",
      "GRASS",
      "GRASS",
      "GRASS",
      "ROAD",
      "GRASS",
      "GRASS",
      "GRASS",
      "GRASS",
      "FOREST",
      "GRASS",
      "GRASS",
      "GRASS",
      "GRASS"
    ],
    [
      "GRASS",
      "GRASS",
      "GRASS",
      "GRASS",
      "GRASS",
      "GRASS",
      "GRASS",
      "GRASS",
      "GRASS",
      "GRASS",
      "ROAD",
      "GRASS",
      "FOREST",
      "GRASS",
      "GRASS",
      "GRASS",
      "FOREST",
      "GRASS",
      "GRASS",
      "GRASS"
    ],
    [
      "GRASS",
      "GRASS",
      "GRASS",
      "GRASS",
      "GRASS",
      "GRASS",
      "GRASS",
      "GRASS",
      "GRASS",
      "FOREST",
      "ROAD",
      "GRASS",
      "GRASS",
      "GRASS",
      "SAND",
      "FOREST",
      "FOREST",
      "GRASS",
      "GRASS",
      "GRASS"
    ],
    [
      "GRASS",
      "GRASS",
      "GRASS",
      "GRASS",
      "GRASS",
      "GRASS",
      "GRASS",
      "FOREST",
      "GRASS",
      "GRASS",
      "ROAD",
      "GRASS",
      "GRASS",
      "GRASS",
      "GRASS",
      "GRASS",
      "GRASS",
      "FOREST",
      "FOREST",
      "GRASS"
    ]
  ],
  "startingPositions": [
    {
      "x": 3,
      "y": 7,
      "faction": "CONFEDERATION"
    },
    {
      "x": 16,
      "y": 7,
      "faction": "RESISTANCE"
    }
  ]
}